XXXXX.XXXXX
X.........X
X.........X
X.........X
X.........X
X.........X
X.........X
X.........X
X.........X
XX1XX1XX1XX