HXXXXXXXXXH
H.........H
H....S....H
H.........H
H.........H
H.........H
H.........H
H....B....H
H.........H
HXXXXXXXXXH