XXXXXXXXXXX
X.........X
X....S....X
X.........X
X.........X
X.........X
X.........X
X....B....X
X.........X
XXXXXXXXXXX